XXXXXXXXXXXXXXXXXXXXXXXXXXXXXXXXX
XXX                         XXXXX
XXX XXXXX XXXXXXXXXXXXXXXXXXXXXXX
XXX    XX XXXXX       XXXXXXXXXXX
XXXXXX XX XXXXX XXXXX XXX     XXX
XXXXXXXXX XXXXX XXXXX XXX XXXXXXX
XX        XXXXX XXXXX XXX     XXX
XX XXXXXXXXXXXX XX    XXXXXXX XXX
XX XXXXX        XX XX XXXXXXX XXX
XX XXXXXXXXXXXXXXX X  XXXXXXX   E
XX XXXXXXXXXXXXXXX XX XXXXXXX XXX
S                  XX         XXX
XXXXXXXXXX XXXXXXXXXXXXXXXXXXXXXX
XXXXXXXXXX                   XXXX
XXXXXXXXXXXXXXXXXXXXXXXXXXXXXXXXX